免券	mmqr
无用之人	myvr
安三胖	aspj
菜菜太强了	cctjl
偷感好重	tghi
中国第金	vgdj
血迷宫	xmgs
呜呜伯	wwbd
石粒	djli
强得可怕	jdkp
强的可怕	jdkp
强疗	jlln
石凯唱想见你	dkixn
圆还缺	yhqt
娜扎恩利合照	nzelv
飞鸟说	fnuv
梁王又在诶哦	lwyze
雀隐	qnyb
今晚下调油价	jwxdj
深海之息	uhvx
圈刹	jria
钎城耳骨夹	qiegg
无编码	mbma
石凯银发伯爵	dkyfj
被扎	bwza
吓鼠	heuu
友谊金	yyjb
吓鼠了	hule
三折叠屏手机	svdbj
樊振东半区	fvdbo
泰国丸美	tgwm
换屏计划	hbjh
有石粒	ydli
云归喜事开机	ygxuj
油价下调	yjxd
贾俄仁加	gerj
左航对接辟谣	zhdjy
事业上升期	uyuuj
郑中基退圈	vvjtj
我马上去催一下	wmuqx
无字奖杯	mzjb
横店群演降薪	hdqyx
石凯上海秒罄	dkuhq
单挂	ijgx
张艺兴开灯	vyxkd
最强种草机	zqvcj
提纳里	dnli
贾冰提示	gbtu
削韧	xnrf
小丽龙	xlls
提确	diqt
强爽	jlul
唐仁健双开	trjuk
女主戏份	nvxf
日区	riou
翟潇闻道歉	dxwdq
强灵	jllk
叶鼎之	xdvi
石洵瑶	dxyc
生咖	ugga
查拳风云	vqfy
灵虚子	lxzi
荷花万字叫大莲	hhmzl
驮拏多	dndo
阳气重	yqis
提瓦特	dwte
胖猫	pjmc
中秋节快乐哦	vqjke
棍丝	gysi
慕强	mujl
战之巅峰	vvdf
短炮	drbc
藏海花预告	chhyg
幸运咖	xyga
牛广盛	ngig
杨少辉	yuhv
我太帅咯	wtug
七天假期	qtjj
乌萨奇	wsji
张真源藏服	vvycf
蒜台	srtd
成都混团抢票	idhtp
贾静雯短发	gjwdf
樊正东	fvds
曾梦雪哭戏	cmxkx
囤水	dyuv
巴克什	bkui
南九	najq
我们的恐龙日记	wmdkj
乐华家族演唱会	lhjzh
约尔	ycer
慧能前传	hnqi
音综	ybzg
真五折真便宜	vwuvy
叶十七	xuqi
蒋奇明好帅	jjmhu
尊界	zyjp
无名之火	mmvh
唐诡西行	tgxh
无侦	movf
泰裤辣	tkla
石宇奇退赛	dyjts
贾西姆	gxmu
糜芳	mwfh
优酷七夕片单	ykqxi
重球	isqq
双人成行	urih
万泰生物	mtuw
国足巴林	gzbl
翟潇闻摔倒	dxwud
精华三	jhsj
大唐双龙传	dtuli
我不想多个爹	wbxdd
贾冰配音毒液	gbpyy
叶珂是谁	xkuu
乐华害我	lhhw
匚匸凵冂	fxqj
行的嘞	hdlw
文俊辉古装	wjhgv
提丰	difg
石破	djpo
拜合拉木黄牌	bglmp
孙颖莎一单	syuyi
娜扎睡衣照	nzuyv
余雨涵	yyhj
拯救比奇堡	vjbjb
单领	ijlk
实胖	uipj
鹭卓山西直播	lvuxb
远单	yrij
糖分手	tfuz
啼作血	tzxp
幽邃地库	ysdk
国足两连胜	gzllu
伊万教练	ymjl
虚空万藏	xkmc
雷犂热刀	llrd
石柯	djke
拍地	pdde
嗯啾嘟	njdu
佩雷兹	plci
大冤种	dyis
无悬念	mxnm
芒果新剧片单	mgxji
约妆	ycvl
小折	xnue
卡拉彼丘	klbq
尼拉	nila
下拉如	xlru
阿斯卡纶	askg
没吻戏	mwxi
黑马喽	hmlz
黑马楼	hmlz
张叶蕾	vxlw
参议长	cyih
狗区	gzou
地府最强销冠	dfzjg
正核实受损物件	vhuuj
最强新人	zjxr
单季	ijji
提档	didh
叔圈白菜	ujbc
放门口就行	fmkjh
无护栏	mhlj
暗区突围	aotw
莞莞类卿	wwlq
纽强	nqjl
生腌	ugaa
轻咖	qkga
种门	ismf
新物种爆炸	xwibv
读信	dzxb
又系广东话噶	yjgdg
我太狂咯	wtkg
孙银沙	syua
泸上阿姨	luay
蒙扎	mgza
李磊受伤离场	lluui
索伯	sobd
不称职的父母	bivdm
换乘爱人	hiar
高启盛	gqig
地鸣	demk
夹胶	gajn
茄皇	jxhl
藏海花张九日	chhvr
曾黎好薄的背	clhbb
秋冬穿搭	qdid
迪亚兹	dyci
哦莫哦莫	emem
蒋奇明演技	jjmyj
雷兹	lwci
有研	yzyj
夏日青提妆	xrqdv
提离职	dlvi
伤害反弹	uhfd
无为而无不为	mweww
宋阿糜	samw
蒋胜龙	juls
岩系	yjji
韩系妆造	hjvz
奇响天外	jxtw
这几单	vjij
定校服	dxfu
终末地	vmde
呲牙舞	zywu
我将化身怨女	wjhun
不限圈	bxjr
非凡中国屏	ffvgb
景甜似锦妆造	jtujz
石凯回应	dkhy
伍佰玩叶珂梗	wbwxg
素裳	suih
现眼包	xybc
华为智慧屏	hwvhb
疯狂囤货	fkdh
左航气胸	zhqx
易点天下	ydtx
黄金跌上热搜	hjdus
与凤行	yfhh
曾之乔孕肚照	cvqyv
原神基尼奇	yujnj
骄阳似我官微	jyuww
等回调	dhdn
无眼	moyj
条件单	tjij
南传	nair
红问了	hwle
全部售罄	qbuq
光椎	glvv
腌辣白菜	albc
石凯巡演	dkxy
风系	fgji
一步江湖	ybjh
合轴	gevz
合养	geyh
冰胖	bkpj
大石碎胸口	ddsxk
副温度	fwdu
女仆长	npih
王冠之重	wgvi
啊米诺斯	amns
徐少强去世	xujqu
人手一单	ruyi
旅行后祛魅	lxhqm
王一博手绳	wybuu
降温穿搭来咯	jwidg
主攻区	vgou
单依纯瘦了	iyiul
三折屏	svbk
网剧藏海花	wjchh
韩国教中文	hgjvw
云离	yyli
联网核查	lwhv
原摄第十二期	yuduj
王子奇路透	wzjlt
况盛发声	kifu
护摩	huma
亏桑提	ksdi
奎桑提	ksdi
石宇奇道歉	dyqdq
拜合拉木	bglm
谁赢都行	uydh
冤种	yris
想提莫	xdmo
蒋峤西	jjxi
叶珂道歉	xkdq
奇拉比	jlbi
掉称	dnif
超觉	icjn
张万森下血了	vmsxl
天府行	tfhh
长乐曲定档	ilqdd
周光召	vguc
卡琪娜	kqna
查看好感度	vkhgd
模版	mobj
惠英红评论区	hyhpo
万茜删博	mqub
小布未来可期	xbwlj
湾区升明月	woumy
筷子夹火箭	kzghj
万楼	molz
慕声的身世	muduu
重肖	isxn
中秋节目单	vqjmi
娜扎生图	nzut
大千生态	dqut
强邦	jlbh
四大扛剧小生	sdgju
贾玲官摄图	glgut
哈啰单车	hldi
好东西金句	hdxjg
吴奇隆退赛	wjlts
高合	gcge
骆健佑	ljyz
月癌	ytai
奇物	jiwu
万舰	mojm
眯觉	mijn
云逛中国航展	ygvgv
花合斗	hgdz
神圣无花果之种	uuwhi
放了个摔炮	flgub
很大很尊很亮	hdhzl
豆神	dzuf
伊万回应获胜	ymhyu
翟佳宁	djnk
柯南皮肤	knpf
左航早日康复	zhzrf
发射区	fuou
辐射区	fuou
拜合拉木破门	bglmm
碧波行	bbhh
蒋奇明崔恩尔	jjmce
抗老瓶颈期	klpjj
五滴血	wdxp
綦美合闺蜜	qmggm
周校	vzjn
扣地	kzde
低像素古早妆	dxsgv
藏海花打夜王	chhdw
查理苏	vlsu
叶珂退网	xktw
天选林栋哲	txldv
温暖冬季	wndj
无规则版球赛	mgzbs
校级警告	jjjg
金鹰奖片单	jyjpi
知申禾行	vuhh
丁禹兮好会哭	dyxhk
西施新传	xuxi
圈速	jrsu
蒋奇明	jjmk
大屏的鹿晗	dbdlh
秘焰沸腾之地	byftd
乃万自证	nmzv
承认败选	irbx
南蚌	nabh
夜礼服假面	ylfjm
国足抵达厦门	gzddm
漫行于以太虚境	mhyyj
单删好友	iuhy
纯胖	iypj
登录日	dlri
高合申请破产	gguqi
王栎鑫体面人	wlxtr
基尼奇	jnji
乐华艺人	lhyr
厦大李胜	udlu
乙游圈	yyjr
摩漾生物	myuw
弹反	djfj
鹅了么订单	elmdd
称象	ifxl
曾三仙	csxm
况盛前女友	kiqny
娜扎央视镜头	nzyut
暴晒	puud
国足连夜回国	gzlyg
万粉	moff
曾黎转型作家	clvxj
一诺耳骨夹	ynegg
石智勇致歉	dvyvq
国足积分	gzjf
加魅	jxmw
张万森	vmsf
张玉宁失单刀	vynud
何炅刘涛主持	hglti
我勒个	wlge
李兰迪评论区	lldpo
天命石	tmdj
藏海花真香了	chhvl
翟钦奇	dqji
单依纯直播	iyivb
肥鯮	fwzs
贾斯汀	gstk
向光而行	xgeh
长乐曲	ilqu
藏海花开播	chhkb
辟兽	biuz
单闪	ijuj
蕉绿	jnlu
黄传	hlir
奇萌	jimg
万兽之王	muvw
炉石传说致歉	ldiuq
瞬风	uyfg
单狙	ijju
万鹏生图	mput
何炅情商	hgqu
登录少年	dlun
李子柒评论区	lzqpo
链接地	ljde
网友考古葛夕	wykgx
抽错了	icle
派出所长	pisi
张角	vhjt
巴林进球越位	bljqw
潘玮柏评论区	pwbpo
单珠	ijvu
锻造石	dzdj
炉石传说掉线	ldiux
波奇酱	bjjl
行有林惜	hylx
万丰奥威	mfaw
无皮村	mpcy
地栽	dezd
法制咖	fvga
标准蛇系美人	bvujr
联动皮肤	ldpf
王子奇谢可寅	wzjxy
叶珂打假叶倪	xkdjn
自己调	zjdn
曾卓君	cvjy
骄阳似我备案	jyuwa
凡希亚	fxya
杨天真补给	ytvbj
叶楚梅	ximw
东契奇走神	dqjzu
贾玲胜诉	glus
重棍	isgy
朝阳站	vyvj
已过万重山	ygmiu
高启强	gqjl
虞书欣壁纸	yuxbv
圌山	ivuj
长在春风里	izifl
单依纯口误	iyikw
退一万步讲	tymbj
伊万换人	ymhr
辛苦了兄弟们	xklxm
时之奇旅	uvjl
玄血	xrxp
准备出线	vbix
貂蝉削弱	dixr
血仆	xppu
曾婉之	cwvi
预定单	ydij
次元踏秋行	cytqh
石原贵雅好帅	dygyu
忙到卡住	mdkv
下雾了	xwle
中秘携手并进	vmxuj
扎完了	zwle
钱塘区	qtou
香港行	xghh
万圣快乐	mukl
奥特灭伽	atmg
周也无袖白裙	vymxq
王子露	wzlz
无盈利	myli
勾石	gzdj
陈清晨贾一凡	iqigf
李川油疯了	liyfl
双十一抢免单	uuyqi
曾黎全包眼线	clqbx
曾蓓勋	cbxy
玱玹	qlxr
杨幂下单等提	ymxdd
奢石	uedj
蜜雪免单	mxmi
拜合拉木状态	bglmt
演员扛票房	yygpf
新易盛	xyig
早上坏	zuhk
接仔	jpzd
恋与深空排期	lyukj
哭娃	kuwa
犟种	jlis
世一绝	uyjt
灵虚子怎么打	lxzzd
何炅口才	hgkc
贾玲嘉奖廖智	gljjv
离谱要求	lpyq
余承东直播	yidvb
输给谁	uguw
扎比子	zbzi
虞书欣北海	yuxbh
佢哋	qudp
洪尧评论区	hyplo
万辞王	mcwh
杨坤主动投案	ykvda
何炅获奖	hghj
叶诗文骨折	xuwgv
覆面系	fmji
巴林进球被吹	bljqi
乐华年会	lhnh
漆艺	qiyi
三十二强	suej
佐仓双叶	zcux
吗咯	mage
飞宵	fwxn
暗河传	ahir
贾一凡放饭了	gyffl
叶海亚	xhya
单三	ijsj
难崩	njbg
单休后的周一	ixhdy
张玉宁反绝杀	vynfu
朝雾卡夫卡	iwkfk
万疆	mojl
强图	jltu
幸福万家	xfmj
雀食	qnui
凡人歌云合	frgyg
解班	jpbj
辉月魔君	hymj
蒋奇明长发	jjmif
石破茂	dpmc
与鬼同行	ygth
新品质	xpvi
豫州行	yvhh
积分夺宝卷	jfdbj
我上我也行	wuwyh
过重阳	gvyh
美露莘	mluf
我勒个豆	wlgd
深圳华强	uvhj
颠公	dmgs
炉石国服回归	ldgfg
李炮	libc
芒果精	mgjk
神圣午睡	uuwu
藏海花尺度	chhid
石凯断层第一	dkdcy
神乐钵	uybo
乐华年会红毯	lhnht
刘繇	lqyz
昭慈暧昧期	vcamj
药综	yczg
葛夕是天使	gxutu
猫系美女	mjmn
劳帕	lcpa
万相之王	mxvw
藏海传团综	chitz
闲来垂钓	xlid
石邑	djyi
曾舜晞直播	cuxvb
晚安安安	waaa
劳弟	lcdi
威然	wwrj
刀剑无眼	djmy
奇兰	jilj
卡摸	kamo
查理苏好帅	vlshu
大侠立志传	dxlvi
无网	mowh
奥扎	aoza
神秘好人	umhr
此行无目的	chwmd
夺宝卷	dbjr
石先锋	dxfg
岗厦北	gubw
解清帅	jquk
况盛清空微博	kiqkb
校记录	jjlu
林一沈月	lyuy
喜欢切屏	xhqb
乜嘢	npye
玛格西男人	mgxnr
新手保护期	xubhj
苏贾	sugu
基尼齐	jnqi
藏海花选角	chhxj
无痛早睡	mtzu
小屏旗舰	xbqj
攀果地	pgde
当代欧楷第一人	ddojr
似火流年	uhln
奇马耶夫	jmyf
牛广盛弃权	ngiqq
叶瑄	xpxr
熬隐	aoyb
石中人	dvrf
双系	ulji
国漫最强祖孙	gmzjs
美妆圈	mvjr
合养精灵	gyjl
深圳华强跌停	uvhjt
伊内斯	ynsi
小提	xndi
辑盗	jidc
恋综	lmzg
拉夏贝尔退市	lxbeu
落匪	lafw
听一万遍	tymb
张云龙简介	vyljj
石智勇哭了	dvykl
潘展乐双纪录	pvlul
弘石	hsdj
波提欧	bdou
对战区	dvou
荣华与炎日之途	rhyyt
胖皇	pjhl
张玉宁绝杀	vynju
大折叠	dudp
乘区	igou
左奇函	zjhj
腾讯中秋片单	txvqi
巴约	bayc
万事可期	wukj
王者柯南联动	wvknd
发条盆友圈	ftpyj
登陆日第九期	dlrdj
秦彻大屏	qidb
贾老板认罪	glbrz
大红屏	dhbk
青春碰头会	qiptk
与辉同行	yhth
马喽	malz
玛露	malz
超声炮	iubc
开阀	kdfa
崔宸曦第	cixd
原神万达电影	yumdy
马拉尼	mlni
四巡万兽之王	sxmuw
浮屠街	ftjp
沪圈	hujr
千重渡	qvdu
日咖	riga
喜单	xiij
石班瑜去世	dbyqu
强军兴军	jjxj
哒咩	damp
达咩	damp
石宇奇状态	dyjvt
地投	detz
刹停	iatk
石宇奇	dyji
叶珂	xpke
魂系	hyji
贝兹利	bcli
交界地	jjde
封印石	fydj
维基奇	wjji
银鱼巷	yyhh
柯然	kerj
又见美合	yjmg
陆光	lqgl
四台共舞	stgw
伯远	bdyr
半扎	bjza
送礼教科书	sljku
查头盔	vtkv
石邑公主	dygv
丁禹兮高马尾	dyxgy
茶话弄	ihls
曾黎裸妆封面	cllvm
韩区	hjou
单踏板	itbj
剥茧	bcjm
奇书疑云	juyy
青提茉莉	qdml
寻香行	xxhh
一别再无归期	ybzwj
樊振东一单	fvdyi
逐区开放	vokf
南珩	nahg
但拓	djta
娜扎原声台词	nzyuc
陆放	lqfh
单依纯	iyiy
三折叠屏	svdb
遗产地	yide
直面屏	vmbk
王一博出发	wybif
破三万	psmo
朴彩英直播	pcyvb
藏海花断更	chhdg
九重紫海报	jvzhb
财务与会计	cwyhj
无卡全套	mkqt
